입영월,군사특기명,입영부대,접수인원,지원인원,남은인원,커트라인
2023년1월,K계열전차승무,육군훈련소,27,62,35,46
2023년1월,M계열전차승무,육군훈련소,31,41,10,48
2023년1월,K계열전차부대정비,육군훈련소,20,31,11,46
2023년1월,M계열전차부대정비,육군훈련소,6,5,-1,0
2023년1월,장갑차조종,육군훈련소,54,57,3,46
2023년1월,장갑차부대정비,육군훈련소,12,35,23,58
2023년1월,K-21보병전투차량부대정비,육군훈련소,7,15,8,63
2023년1월,K-55자주포조종,육군훈련소,43,35,-8,56
2023년1월,K-9자주포조종,육군훈련소,48,58,10,46
2023년1월,K239포병,육군훈련소,38,35,-3,53
2023년1월,M/A포병,육군훈련소,5,9,4,56
2023년1월,사격지휘,육군훈련소,62,47,-15,54
2023년1월,포병레이더,육군훈련소,4,7,3,56
2023년1월,포병측지,육군훈련소,20,31,11,56
2023년1월,현무포병,육군훈련소,5,7,2,56
2023년1월,발칸운용/정비,육군훈련소,61,79,18,46
2023년1월,오리콘운용/정비,육군훈련소,20,36,16,46
2023년1월,비호운용/정비,육군훈련소,29,57,28,46
2023년1월,방공작전통제,육군훈련소,30,85,55,51
2023년1월,휴대용유도무기운용/정비,육군훈련소,17,72,55,52
2023년1월,천마운용/정비,육군훈련소,19,52,33,54
2023년1월,방공레이더운용/정비,육군훈련소,18,70,52,55
2023년1월,군사정보,육군훈련소,28,62,34,61
2023년1월,감시장비운용,육군훈련소,172,159,-13,52
2023년1월,야전건설,육군훈련소,38,50,12,54
2023년1월,소방장비,육군훈련소,15,45,30,60
2023년1월,배관/기계설비,육군훈련소,1,9,8,84
2023년1월,전기설비,육군훈련소,5,73,68,87
2023년1월,정수장비운용,육군훈련소,10,13,3,56
2023년1월,크레인운용,육군훈련소,5,9,4,61
2023년1월,발전기운용/정비,육군훈련소,12,20,8,58
2023년1월,공병장비부대정비,육군훈련소,2,1,-1,90
2023년1월,전술통신장비운용/정비,육군훈련소,242,283,41,52
2023년1월,무선전송장비운용/정비,육군훈련소,23,66,43,59
2023년1월,이동통신장비운용/정비,육군훈련소,17,21,4,46
2023년1월,교환시설운용/정비,육군훈련소,4,12,8,61
2023년1월,MW운용/정비,육군훈련소,13,86,73,84
2023년1월,네트워크운용/정비,육군훈련소,27,68,41,61
2023년1월,전술C4I운용/정비,육군훈련소,48,58,10,55
2023년1월,정보체계운용/정비,육군훈련소,46,63,17,56
2023년1월,항공운항/관제,육군훈련소,12,41,29,63
2023년1월,화생방,육군훈련소,8,43,35,64
2023년1월,연막,육군훈련소,10,45,35,65
2023년1월,화생방제독,육군훈련소,162,190,28,56
2023년1월,화생방정찰,육군훈련소,19,37,18,58
2023년1월,총기정비,육군훈련소,6,9,3,60
2023년1월,화포정비,육군훈련소,2,3,1,56
2023년1월,전차정비,육군훈련소,8,8,0,52
2023년1월,유선장비정비,육군훈련소,8,15,7,59
2023년1월,무선장비정비,육군훈련소,10,24,14,62
2023년1월,특수통신장비정비,육군훈련소,3,14,11,57
2023년1월,차량정비,육군훈련소,11,42,31,68
2023년1월,발전기정비,육군훈련소,7,17,10,60
2023년1월,용접/기계공작,육군훈련소,1,21,20,90
2023년1월,화생방장비정비,육군훈련소,4,11,7,61
2023년1월,탄약관리,육군훈련소,98,133,35,54
2023년1월,장비수리부속공구보급,육군훈련소,36,44,8,55
2023년1월,편성보급,육군훈련소,107,87,-20,52
2023년1월,영현등록,육군훈련소,4,8,4,58
2023년1월,지원보급,육군훈련소,44,68,24,56
2023년1월,연료관리,육군훈련소,35,38,3,52
2023년1월,물자근무지원,육군훈련소,15,31,16,56
2023년1월,조리,육군훈련소,269,151,-118,54
2023년1월,수송운용(차량운전),육군훈련소,834,1479,645,98
2023년1월,수송운용(차량운전),1사단,61,191,130,102
2023년1월,수송운용(차량운전),25사단,61,144,83,99
2023년1월,수송운용(차량운전),9사단,61,211,150,101
2023년1월,수송운용(차량운전),3사단,54,99,45,97
2023년1월,수송운용(차량운전),6사단,64,121,57,97
2023년1월,수송운용(차량운전),5사단,62,110,48,97
2023년1월,수송운용(차량운전),28사단,62,122,60,97
2023년1월,수송운용(차량운전),51사단,66,379,313,104
2023년1월,수송운용(차량운전),55사단,63,378,315,104
2023년1월,견인차량운전,육군훈련소,30,26,-4,97
2023년1월,지게차운전,육군훈련소,28,47,19,66
2023년1월,차륜형장갑차운전,육군훈련소,34,43,9,96
2023년1월,차량부대정비,육군훈련소,87,127,40,50
2023년1월,K-53계열차량운전,육군훈련소,7,34,27,99
2023년1월,구난차량운전,육군훈련소,37,47,10,93
2023년1월,크레인차량운전,육군훈련소,16,17,1,98
2023년1월,전장이동통제,육군훈련소,34,93,59,63
2023년1월,항만운용,육군훈련소,11,31,20,61
2023년1월,선박운용,육군훈련소,3,14,11,62
2023년1월,군사경찰,육군훈련소,83,154,71,40
2023년1월,재정회계,육군훈련소,9,58,49,80
2023년1월,영상제작,육군훈련소,2,49,47,81
2023년1월,일반의무,육군훈련소,155,939,784,68
2023년1월,수의,육군훈련소,28,40,12,56
2023년1월,의무보급,육군훈련소,10,74,64,69
2023년1월,야전건설(중졸),육군훈련소,3,0,-3,0
2023년1월,배관/기계설비(중졸),육군훈련소,1,0,-1,0
2023년1월,전기설비(중졸),육군훈련소,3,0,-3,0
2023년1월,용접/기계공작(중졸),육군훈련소,2,0,-2,0
2023년1월,조리(중졸),육군훈련소,10,0,-10,0
2023년1월,수송운용(중졸),육군훈련소,61,0,-61,0
2023년1월,견인차량운전(중졸),육군훈련소,2,0,-2,0
2023년1월,지게차운전(중졸),육군훈련소,4,0,-4,0
2023년1월,차량부대정비(중졸),육군훈련소,5,0,-5,0
2023년1월,구난차량운전(중졸),육군훈련소,3,0,-3,0
2023년1월,선박운용(중졸),육군훈련소,1,0,-1,0
2023년1월,전문간호,육군훈련소,6,10,4,74
2023년1월,신호정보/전자전운용,육군훈련소,16,56,40,61
2023년2월,K계열전차승무,육군훈련소,54,76,22,46
2023년2월,장갑차조종,육군훈련소,93,91,-2,46
2023년2월,K-21보병전투차량승무,육군훈련소,23,32,9,46
2023년2월,K-55자주포조종,육군훈련소,43,64,21,46
2023년2월,K-9자주포조종,육군훈련소,48,47,-1,46
2023년2월,K239포병,육군훈련소,39,31,-8,57
2023년2월,M/A포병,육군훈련소,5,9,4,59
2023년2월,사격지휘,육군훈련소,93,44,-49,52
2023년2월,포병레이더,육군훈련소,2,10,8,62
2023년2월,포병측지,육군훈련소,20,22,2,62
2023년2월,현무포병,육군훈련소,5,13,8,60
2023년2월,휴대용유도무기운용/정비,육군훈련소,17,408,391,58
2023년2월,군사정보,육군훈련소,27,90,63,64
2023년2월,땅굴탐지,육군훈련소,20,19,-1,54
2023년2월,감시장비운용,육군훈련소,167,200,33,52
2023년2월,야전건설,육군훈련소,11,80,69,78
2023년2월,배관/기계설비,육군훈련소,2,20,18,87
2023년2월,다목적굴착기운전,육군훈련소,2,12,10,74
2023년2월,도하장비조종,육군훈련소,9,12,3,58
2023년2월,공기압축기운용,육군훈련소,2,3,1,58
2023년2월,크레인운용,육군훈련소,4,13,9,69
2023년2월,로더운전,육군훈련소,10,17,7,64
2023년2월,굴착기운용,육군훈련소,1,73,72,85
2023년2월,발전기운용/정비,육군훈련소,9,60,51,88
2023년2월,공병장비부대정비,육군훈련소,3,3,0,52
2023년2월,전술통신장비운용/정비,육군훈련소,237,113,-124,52
2023년2월,무선전송장비운용/정비,육군훈련소,52,160,108,61
2023년2월,이동통신장비운용/정비,육군훈련소,71,26,-45,56
2023년2월,정보통신망관리장비운용/정비,육군훈련소,16,52,36,61
2023년2월,교환시설운용/정비,육군훈련소,14,23,9,56
2023년2월,위성운용/정비,육군훈련소,26,86,60,65
2023년2월,레이다운용/정비,육군훈련소,24,52,28,58
2023년2월,네트워크운용/정비,육군훈련소,56,114,58,59
2023년2월,전술C4I운용/정비,육군훈련소,47,84,37,58
2023년2월,정보체계운용/정비,육군훈련소,44,78,34,58
2023년2월,기동헬기운용,육군훈련소,31,60,29,61
2023년2월,화생방,육군훈련소,6,163,157,92
2023년2월,화생방제독,육군훈련소,64,89,25,55
2023년2월,유선장비정비,육군훈련소,9,27,18,61
2023년2월,무선장비정비,육군훈련소,10,54,44,83
2023년2월,공병장비정비,육군훈련소,7,24,17,68
2023년2월,용접/기계공작,육군훈련소,2,36,34,88
2023년2월,화생방장비정비,육군훈련소,5,17,12,62
2023년2월,의무장비정비,육군훈련소,7,87,80,91
2023년2월,탄약관리,육군훈련소,93,127,34,56
2023년2월,편성보급,육군훈련소,34,88,54,60
2023년2월,지원보급,육군훈련소,89,104,15,52
2023년2월,연료관리,육군훈련소,35,47,12,52
2023년2월,물자근무지원,육군훈련소,15,76,61,63
2023년2월,조리,육군훈련소,186,178,-8,56
2023년2월,수송운용(차량운전),육군훈련소,1000,2531,1531,100
2023년2월,수송운용(차량운전),1사단,31,182,151,106
2023년2월,수송운용(차량운전),25사단,61,223,162,101
2023년2월,수송운용(차량운전),9사단,61,317,256,103
2023년2월,수송운용(차량운전),3사단,53,152,99,99
2023년2월,수송운용(차량운전),6사단,50,143,93,99
2023년2월,수송운용(차량운전),5사단,62,188,126,100
2023년2월,수송운용(차량운전),28사단,62,201,139,100
2023년2월,수송운용(차량운전),51사단,69,519,450,106
2023년2월,수송운용(차량운전),55사단,33,413,380,107
2023년2월,차륜형장갑차운전,육군훈련소,34,43,9,93
2023년2월,차량부대정비,육군훈련소,80,92,12,55
2023년2월,구난차량운전,육군훈련소,35,52,17,96
2023년2월,항만운용,육군훈련소,11,48,37,62
2023년2월,선박운용,육군훈련소,3,11,8,70
2023년2월,군사경찰,육군훈련소,166,251,85,48
2023년2월,재정회계,육군훈련소,9,74,65,80
2023년2월,야전건설(중졸),육군훈련소,1,0,-1,0
2023년2월,배관/기계설비(중졸),육군훈련소,1,0,-1,0
2023년2월,굴착기운용(중졸),육군훈련소,1,0,-1,0
2023년2월,용접/기계공작(중졸),육군훈련소,1,0,-1,0
2023년2월,조리(중졸),육군훈련소,6,0,-6,0
2023년2월,수송운용(중졸),육군훈련소,48,0,-48,0
2023년2월,지게차운전(중졸),육군훈련소,1,0,-1,0
2023년2월,차량부대정비(중졸),육군훈련소,5,0,-5,0
2023년2월,구난차량운전(중졸),육군훈련소,3,0,-3,0
2023년2월,선박운용(중졸),육군훈련소,1,0,-1,0
2023년2월,전문치과,육군훈련소,2,0,-2,0
2023년2월,전문임상병리,육군훈련소,3,2,-1,82
2023년2월,전문방사선촬영,육군훈련소,5,1,-4,0
2023년2월,전문약제,육군훈련소,15,2,-13,82
2023년2월,전문물리치료,육군훈련소,3,8,5,76
2023년2월,천호운용/정비,육군훈련소,11,127,116,55
2023년2월,신호정보/전자전운용,육군훈련소,15,94,79,72
2023년3월,K계열전차승무,육군훈련소,54,120,66,52
2023년3월,K계열전차부대정비,육군훈련소,19,31,12,46
2023년3월,M계열전차부대정비,육군훈련소,5,7,2,52
2023년3월,장갑차조종,육군훈련소,108,168,60,46
2023년3월,장갑차부대정비,육군훈련소,12,26,14,61
2023년3월,K-21보병전투차량승무,육군훈련소,23,40,17,49
2023년3월,K-55자주포조종,육군훈련소,43,35,-8,46
2023년3월,K-9자주포조종,육군훈련소,49,61,12,48
2023년3월,K239포병,육군훈련소,48,33,-15,53
2023년3월,M/A포병,육군훈련소,5,5,0,54
2023년3월,사격지휘,육군훈련소,124,80,-44,53
2023년3월,포병레이더,육군훈련소,2,11,9,70
2023년3월,포병측지,육군훈련소,16,49,33,62
2023년3월,현무포병,육군훈련소,6,12,6,58
2023년3월,발칸운용/정비,육군훈련소,62,225,163,53
2023년3월,비호운용/정비,육군훈련소,29,114,85,53
2023년3월,방공작전통제,육군훈련소,24,355,331,56
2023년3월,천마운용/정비,육군훈련소,20,218,198,66
2023년3월,방공레이더운용/정비,육군훈련소,12,262,250,84
2023년3월,군사정보,육군훈련소,30,106,76,64
2023년3월,감시장비운용,육군훈련소,170,298,128,59
2023년3월,소방장비,육군훈련소,15,93,78,70
2023년3월,배관/기계설비,육군훈련소,1,18,17,88
2023년3월,도하장비조종,육군훈련소,6,9,3,52
2023년3월,공기압축기운용,육군훈련소,1,5,4,86
2023년3월,크레인운용,육군훈련소,5,24,19,69
2023년3월,굴착기운용,육군훈련소,1,68,67,89
2023년3월,발전기운용/정비,육군훈련소,12,78,66,88
2023년3월,공병장비부대정비,육군훈련소,3,4,1,56
2023년3월,전술통신장비운용/정비,육군훈련소,178,151,-27,49
2023년3월,무선전송장비운용/정비,육군훈련소,78,172,94,59
2023년3월,이동통신장비운용/정비,육군훈련소,93,49,-44,54
2023년3월,정보통신망관리장비운용/정비,육군훈련소,16,76,60,68
2023년3월,교환시설운용/정비,육군훈련소,10,28,18,61
2023년3월,MW운용/정비,육군훈련소,13,154,141,91
2023년3월,위성운용/정비,육군훈련소,54,111,57,60
2023년3월,레이다운용/정비,육군훈련소,46,85,39,58
2023년3월,네트워크운용/정비,육군훈련소,85,173,88,60
2023년3월,전술C4I운용/정비,육군훈련소,45,104,59,59
2023년3월,정보체계운용/정비,육군훈련소,38,101,63,61
2023년3월,항공운항/관제,육군훈련소,12,68,56,69
2023년3월,공격헬기정비,육군훈련소,14,46,32,76
2023년3월,기동헬기운용,육군훈련소,34,50,16,58
2023년3월,화생방,육군훈련소,8,142,134,86
2023년3월,화생방제독,육군훈련소,122,96,-26,55
2023년3월,화생방정찰,육군훈련소,18,115,97,67
2023년3월,로켓무기정비,육군훈련소,7,21,14,58
2023년3월,총기정비,육군훈련소,7,19,12,64
2023년3월,광학기재정비,육군훈련소,7,58,51,86
2023년3월,감시장비정비,육군훈련소,3,24,21,85
2023년3월,유선장비정비,육군훈련소,7,31,24,63
2023년3월,무선장비정비,육군훈련소,10,51,41,64
2023년3월,공병장비정비,육군훈련소,7,19,12,62
2023년3월,발전기정비,육군훈련소,6,45,39,89
2023년3월,용접/기계공작,육군훈련소,2,45,43,94
2023년3월,화생방장비정비,육군훈련소,3,13,10,60
2023년3월,의무장비정비,육군훈련소,7,85,78,93
2023년3월,탄약관리,육군훈련소,134,195,61,56
2023년3월,장비수리부속공구보급,육군훈련소,18,62,44,61
2023년3월,편성보급,육군훈련소,71,145,74,59
2023년3월,지원보급,육군훈련소,89,167,78,58
2023년3월,연료관리,육군훈련소,56,67,11,52
2023년3월,물자근무지원,육군훈련소,15,74,59,63
2023년3월,조리,육군훈련소,248,450,202,52
2023년3월,수송운용(차량운전),육군훈련소,1129,3890,2761,101
2023년3월,수송운용(차량운전),1사단,61,397,336,106
2023년3월,수송운용(차량운전),25사단,30,223,193,104
2023년3월,수송운용(차량운전),9사단,31,371,340,107
2023년3월,수송운용(차량운전),3사단,53,251,198,101
2023년3월,수송운용(차량운전),6사단,38,180,142,101
2023년3월,수송운용(차량운전),5사단,31,178,147,103
2023년3월,수송운용(차량운전),28사단,62,362,300,103
2023년3월,수송운용(차량운전),51사단,35,595,560,108
2023년3월,수송운용(차량운전),55사단,24,530,506,110
2023년3월,견인차량운전,육군훈련소,30,48,18,96
2023년3월,지게차운전,육군훈련소,25,72,47,69
2023년3월,차량부대정비,육군훈련소,170,155,-15,52
2023년3월,구난차량운전,육군훈련소,35,66,31,98
2023년3월,크레인차량운전,육군훈련소,16,21,5,93
2023년3월,전장이동통제,육군훈련소,16,136,120,74
2023년3월,항만운용,육군훈련소,11,65,54,65
2023년3월,군사경찰,육군훈련소,83,272,189,52
2023년3월,영상제작,육군훈련소,4,89,85,80
2023년3월,일반의무,육군훈련소,154,1707,1553,72
2023년3월,배관/기계설비(중졸),육군훈련소,1,0,-1,0
2023년3월,굴착기운용(중졸),육군훈련소,1,0,-1,0
2023년3월,용접/기계공작(중졸),육군훈련소,1,0,-1,0
2023년3월,조리(중졸),육군훈련소,8,0,-8,0
2023년3월,수송운용(중졸),육군훈련소,58,1,-57,55
2023년3월,견인차량운전(중졸),육군훈련소,2,0,-2,0
2023년3월,지게차운전(중졸),육군훈련소,2,0,-2,0
2023년3월,차량부대정비(중졸),육군훈련소,10,0,-10,0
2023년3월,구난차량운전(중졸),육군훈련소,5,0,-5,0
2023년3월,전문간호,육군훈련소,7,11,4,76
2023년3월,신호정보/전자전운용,육군훈련소,15,80,65,66
2023년4월,K계열전차승무,육군훈련소,81,145,64,49
2023년4월,전차통신정비,육군훈련소,3,15,12,84
2023년4월,장갑차조종,육군훈련소,132,213,81,48
2023년4월,장갑차부대정비,육군훈련소,12,60,48,68
2023년4월,K-21보병전투차량승무,육군훈련소,23,44,21,48
2023년4월,K-55자주포조종,육군훈련소,44,56,12,46
2023년4월,K-9자주포조종,육군훈련소,34,48,14,46
2023년4월,K239포병,육군훈련소,39,55,16,57
2023년4월,M/A포병,육군훈련소,5,10,5,58
2023년4월,사격지휘,육군훈련소,124,55,-69,54
2023년4월,포병레이더,육군훈련소,1,9,8,93
2023년4월,포병측지,육군훈련소,9,28,19,62
2023년4월,현무포병,육군훈련소,1,3,2,60
2023년4월,발칸운용/정비,육군훈련소,59,266,207,54
2023년4월,오리콘운용/정비,육군훈련소,20,116,96,55
2023년4월,비호운용/정비,육군훈련소,29,137,108,54
2023년4월,휴대용유도무기운용/정비,육군훈련소,17,430,413,59
2023년4월,천마운용/정비,육군훈련소,19,199,180,64
2023년4월,군사정보,육군훈련소,26,105,79,68
2023년4월,감시장비운용,육군훈련소,79,275,196,69
2023년4월,전기설비,육군훈련소,1,52,51,96
2023년4월,장갑전투도저운전,육군훈련소,5,9,4,61
2023년4월,정수장비운용,육군훈련소,7,63,56,68
2023년4월,공기압축기운용,육군훈련소,1,3,2,62
2023년4월,크레인운용,육군훈련소,4,21,17,67
2023년4월,로더운전,육군훈련소,9,32,23,72
2023년4월,발전기운용/정비,육군훈련소,4,34,30,89
2023년4월,전술통신장비운용/정비,육군훈련소,264,261,-3,48
2023년4월,무선전송장비운용/정비,육군훈련소,63,188,125,64
2023년4월,이동통신장비운용/정비,육군훈련소,70,44,-26,54
2023년4월,정보통신망관리장비운용/정비,육군훈련소,13,73,60,70
2023년4월,교환시설운용/정비,육군훈련소,14,35,21,62
2023년4월,MW운용/정비,육군훈련소,11,131,120,93
2023년4월,위성운용/정비,육군훈련소,22,102,80,70
2023년4월,레이다운용/정비,육군훈련소,20,69,49,63
2023년4월,네트워크운용/정비,육군훈련소,51,165,114,66
2023년4월,전술C4I운용/정비,육군훈련소,71,176,105,62
2023년4월,정보체계운용/정비,육군훈련소,36,116,80,64
2023년4월,기동헬기운용,육군훈련소,32,82,50,64
2023년4월,화생방제독,육군훈련소,90,194,104,62
2023년4월,총기정비,육군훈련소,6,21,15,84
2023년4월,화포정비,육군훈련소,1,3,2,78
2023년4월,광학기재정비,육군훈련소,6,50,44,86
2023년4월,감시장비정비,육군훈련소,3,19,16,67
2023년4월,전차정비,육군훈련소,6,17,11,64
2023년4월,자주포야전정비,육군훈련소,4,6,2,60
2023년4월,장갑차야전정비,육군훈련소,2,3,1,58
2023년4월,유선장비정비,육군훈련소,7,37,30,65
2023년4월,무선장비정비,육군훈련소,9,56,47,76
2023년4월,차량정비,육군훈련소,18,87,69,82
2023년4월,공병장비정비,육군훈련소,6,15,9,60
2023년4월,발전기정비,육군훈련소,3,23,20,88
2023년4월,용접/기계공작,육군훈련소,2,44,42,90
2023년4월,화생방장비정비,육군훈련소,3,16,13,67
2023년4월,의무장비정비,육군훈련소,7,74,67,93
2023년4월,탄약관리,육군훈련소,131,244,113,60
2023년4월,장비수리부속공구보급,육군훈련소,17,71,54,65
2023년4월,편성보급,육군훈련소,33,122,89,62
2023년4월,영현등록,육군훈련소,4,16,12,68
2023년4월,지원보급,육군훈련소,88,200,112,60
2023년4월,연료관리,육군훈련소,50,92,42,58
2023년4월,물자근무지원,육군훈련소,15,80,65,65
2023년4월,조리,육군훈련소,196,437,241,52
2023년4월,수송운용(차량운전),육군훈련소,793,3565,2772,103
2023년4월,수송운용(차량운전),1사단,61,341,280,107
2023년4월,수송운용(차량운전),25사단,61,323,262,105
2023년4월,수송운용(차량운전),9사단,61,399,338,107
2023년4월,수송운용(차량운전),3사단,27,137,110,101
2023년4월,수송운용(차량운전),6사단,64,310,246,102
2023년4월,수송운용(차량운전),5사단,61,302,241,104
2023년4월,수송운용(차량운전),28사단,61,317,256,104
2023년4월,수송운용(차량운전),51사단,33,380,347,109
2023년4월,수송운용(차량운전),55사단,50,558,508,110
2023년4월,견인차량운전,육군훈련소,30,76,46,99
2023년4월,지게차운전,육군훈련소,28,98,70,70
2023년4월,차륜형장갑차운전,육군훈련소,34,70,36,96
2023년4월,차량부대정비,육군훈련소,47,82,35,60
2023년4월,K-53계열차량운전,육군훈련소,7,16,9,95
2023년4월,구난차량운전,육군훈련소,35,84,49,98
2023년4월,항만운용,육군훈련소,11,72,61,77
2023년4월,선박운용,육군훈련소,3,19,16,69
2023년4월,군사경찰,육군훈련소,83,340,257,52
2023년4월,재정회계,육군훈련소,9,96,87,80
2023년4월,일반의무,육군훈련소,94,1475,1381,75
2023년4월,전기설비(중졸),육군훈련소,1,0,-1,0
2023년4월,용접/기계공작(중졸),육군훈련소,1,1,0,50
2023년4월,조리(중졸),육군훈련소,6,0,-6,0
2023년4월,수송운용(중졸),육군훈련소,40,1,-39,46
2023년4월,견인차량운전(중졸),육군훈련소,2,0,-2,0
2023년4월,지게차운전(중졸),육군훈련소,2,0,-2,0
2023년4월,차량부대정비(중졸),육군훈련소,5,0,-5,0
2023년4월,구난차량운전(중졸),육군훈련소,5,0,-5,0
2023년4월,선박운용(중졸),육군훈련소,1,0,-1,0
2023년4월,전문치과,육군훈련소,2,7,5,77
2023년4월,전문임상병리,육군훈련소,2,4,2,71
2023년4월,전문방사선촬영,육군훈련소,5,5,0,76
2023년4월,전문약제,육군훈련소,15,31,16,80
2023년4월,전문물리치료,육군훈련소,3,6,3,78
2023년4월,신호정보/전자전운용,육군훈련소,45,132,87,65
2023년5월,K계열전차승무,육군훈련소,95,126,31,46
2023년5월,M계열전차승무,육군훈련소,29,36,7,46
2023년5월,장갑차조종,육군훈련소,118,146,28,46
2023년5월,장갑차부대정비,육군훈련소,12,39,27,65
2023년5월,K-21보병전투차량부대정비,육군훈련소,7,23,16,65
2023년5월,K-55자주포조종,육군훈련소,32,36,4,46
2023년5월,K-9자주포조종,육군훈련소,34,42,8,46
2023년5월,K239포병,육군훈련소,30,34,4,54
2023년5월,M/A포병,육군훈련소,4,5,1,56
2023년5월,사격지휘,육군훈련소,143,45,-98,54
2023년5월,포병레이더,육군훈련소,1,2,1,67
2023년5월,포병측지,육군훈련소,16,27,11,56
2023년5월,현무포병,육군훈련소,7,8,1,58
2023년5월,발칸운용/정비,육군훈련소,61,344,283,56
2023년5월,방공작전통제,육군훈련소,30,253,223,58
2023년5월,휴대용유도무기운용/정비,육군훈련소,16,255,239,60
2023년5월,군사정보,육군훈련소,40,105,65,64
2023년5월,땅굴탐지,육군훈련소,18,9,-9,58
2023년5월,감시장비운용,육군훈련소,258,295,37,52
2023년5월,소방장비,육군훈련소,15,53,38,67
2023년5월,배관/기계설비,육군훈련소,1,14,13,93
2023년5월,전기설비,육군훈련소,1,47,46,93
2023년5월,다목적굴착기운전,육군훈련소,3,43,40,75
2023년5월,도하장비조종,육군훈련소,7,11,4,63
2023년5월,정수장비운용,육군훈련소,9,31,22,63
2023년5월,공기압축기운용,육군훈련소,1,4,3,88
2023년5월,크레인운용,육군훈련소,5,14,9,67
2023년5월,로더운전,육군훈련소,9,20,11,65
2023년5월,발전기운용/정비,육군훈련소,9,27,18,84
2023년5월,전술통신장비운용/정비,육군훈련소,308,135,-173,52
2023년5월,무선전송장비운용/정비,육군훈련소,101,144,43,46
2023년5월,이동통신장비운용/정비,육군훈련소,117,51,-66,56
2023년5월,정보통신망관리장비운용/정비,육군훈련소,30,50,20,60
2023년5월,교환시설운용/정비,육군훈련소,15,16,1,52
2023년5월,MW운용/정비,육군훈련소,27,101,74,86
2023년5월,위성운용/정비,육군훈련소,46,109,63,66
2023년5월,레이다운용/정비,육군훈련소,40,52,12,56
2023년5월,네트워크운용/정비,육군훈련소,113,175,62,59
2023년5월,전술C4I운용/정비,육군훈련소,46,106,60,63
2023년5월,정보체계운용/정비,육군훈련소,38,69,31,62
2023년5월,기동헬기운용,육군훈련소,90,80,-10,54
2023년5월,화생방제독,육군훈련소,63,99,36,56
2023년5월,화생방정찰,육군훈련소,18,107,89,69
2023년5월,총기정비,육군훈련소,5,13,8,64
2023년5월,화포정비,육군훈련소,1,3,2,66
2023년5월,광학기재정비,육군훈련소,10,49,39,86
2023년5월,감시장비정비,육군훈련소,3,17,14,67
2023년5월,전차정비,육군훈련소,10,14,4,54
2023년5월,유선장비정비,육군훈련소,13,31,18,60
2023년5월,무선장비정비,육군훈련소,9,32,23,71
2023년5월,차량정비,육군훈련소,56,78,22,56
2023년5월,공병장비정비,육군훈련소,6,15,9,60
2023년5월,발전기정비,육군훈련소,8,23,15,72
2023년5월,용접/기계공작,육군훈련소,1,24,23,93
2023년5월,화생방장비정비,육군훈련소,8,17,9,64
2023년5월,탄약관리,육군훈련소,129,178,49,57
2023년5월,장비수리부속공구보급,육군훈련소,17,70,53,68
2023년5월,편성보급,육군훈련소,33,97,64,62
2023년5월,지원보급,육군훈련소,93,141,48,59
2023년5월,연료관리,육군훈련소,25,37,12,57
2023년5월,물자근무지원,육군훈련소,15,55,40,64
2023년5월,조리,육군훈련소,330,388,58,46
2023년5월,수송운용(차량운전),육군훈련소,1501,3050,1549,100
2023년5월,수송운용(차량운전),1사단,61,239,178,107
2023년5월,수송운용(차량운전),25사단,60,221,161,105
2023년5월,수송운용(차량운전),9사단,61,288,227,107
2023년5월,수송운용(차량운전),3사단,53,162,109,101
2023년5월,수송운용(차량운전),6사단,72,216,144,102
2023년5월,수송운용(차량운전),5사단,60,201,141,104
2023년5월,수송운용(차량운전),28사단,60,196,136,103
2023년5월,수송운용(차량운전),51사단,72,480,408,108
2023년5월,수송운용(차량운전),55사단,36,308,272,110
2023년5월,견인차량운전,육군훈련소,30,47,17,97
2023년5월,지게차운전,육군훈련소,25,68,43,69
2023년5월,차륜형장갑차운전,육군훈련소,34,50,16,95
2023년5월,차량부대정비,육군훈련소,60,68,8,56
2023년5월,K-53계열차량운전,육군훈련소,4,8,4,94
2023년5월,구난차량운전,육군훈련소,35,54,19,96
2023년5월,크레인차량운전,육군훈련소,16,24,8,96
2023년5월,전장이동통제,육군훈련소,16,116,100,77
2023년5월,항만운용,육군훈련소,12,43,31,67
2023년5월,선박운용,육군훈련소,3,12,9,78
2023년5월,군사경찰,육군훈련소,166,287,121,49
2023년5월,일반의무,육군훈련소,212,1253,1041,73
2023년5월,배관/기계설비(중졸),육군훈련소,1,0,-1,0
2023년5월,전기설비(중졸),육군훈련소,1,0,-1,0
2023년5월,용접/기계공작(중졸),육군훈련소,1,0,-1,0
2023년5월,조리(중졸),육군훈련소,10,2,-8,50
2023년5월,수송운용(중졸),육군훈련소,73,0,-73,0
2023년5월,견인차량운전(중졸),육군훈련소,2,0,-2,0
2023년5월,지게차운전(중졸),육군훈련소,2,0,-2,0
2023년5월,차량부대정비(중졸),육군훈련소,10,0,-10,0
2023년5월,구난차량운전(중졸),육군훈련소,5,0,-5,0
2023년5월,선박운용(중졸),육군훈련소,1,1,0,46
2023년5월,전문간호,육군훈련소,7,14,7,73
2023년5월,신호정보/전자전운용,육군훈련소,15,53,38,67
2023년6월,K계열전차승무,육군훈련소,96,100,4,46
2023년6월,장갑차조종,육군훈련소,117,118,1,46
2023년6월,장갑차부대정비,육군훈련소,12,38,26,65
2023년6월,K-21보병전투차량승무,육군훈련소,23,33,10,46
2023년6월,K-55자주포조종,육군훈련소,32,38,6,46
2023년6월,K-9자주포조종,육군훈련소,34,42,8,46
2023년6월,K239포병,육군훈련소,30,18,-12,52
2023년6월,M/A포병,육군훈련소,4,2,-2,0
2023년6월,사격지휘,육군훈련소,80,37,-43,56
2023년6월,포병레이더,육군훈련소,1,2,1,93
2023년6월,포병측지,육군훈련소,17,15,-2,54
2023년6월,현무포병,육군훈련소,7,8,1,60
2023년6월,발칸운용/정비,육군훈련소,62,183,121,52
2023년6월,비호운용/정비,육군훈련소,29,82,53,50
2023년6월,휴대용유도무기운용/정비,육군훈련소,16,206,190,57
2023년6월,천마운용/정비,육군훈련소,19,109,90,61
2023년6월,방공레이더운용/정비,육군훈련소,16,132,116,60
2023년6월,군사정보,육군훈련소,26,67,41,63
2023년6월,감시장비운용,육군훈련소,173,127,-46,50
2023년6월,배관/기계설비,육군훈련소,2,6,4,80
2023년6월,전기설비,육군훈련소,1,35,34,92
2023년6월,도하장비조종,육군훈련소,7,14,7,63
2023년6월,정수장비운용,육군훈련소,11,36,25,66
2023년6월,공기압축기운용,육군훈련소,1,2,1,90
2023년6월,크레인운용,육군훈련소,5,17,12,68
2023년6월,로더운전,육군훈련소,9,25,16,66
2023년6월,전술통신장비운용/정비,육군훈련소,199,128,-71,52
2023년6월,무선전송장비운용/정비,육군훈련소,102,101,-1,52
2023년6월,이동통신장비운용/정비,육군훈련소,94,55,-39,55
2023년6월,교환시설운용/정비,육군훈련소,10,13,3,56
2023년6월,MW운용/정비,육군훈련소,14,54,40,81
2023년6월,위성운용/정비,육군훈련소,47,49,2,53
2023년6월,레이다운용/정비,육군훈련소,20,28,8,59
2023년6월,네트워크운용/정비,육군훈련소,75,64,-11,52
2023년6월,전술C4I운용/정비,육군훈련소,85,86,1,56
2023년6월,정보체계운용/정비,육군훈련소,31,39,8,56
2023년6월,기동헬기운용,육군훈련소,27,38,11,52
2023년6월,화생방제독,육군훈련소,63,104,41,52
2023년6월,총기정비,육군훈련소,8,12,4,52
2023년6월,무선장비정비,육군훈련소,10,32,22,68
2023년6월,발전기정비,육군훈련소,5,26,21,88
2023년6월,용접/기계공작,육군훈련소,1,23,22,95
2023년6월,의무장비정비,육군훈련소,6,36,30,87
2023년6월,탄약관리,육군훈련소,133,122,-11,48
2023년6월,장비수리부속공구보급,육군훈련소,18,40,22,60
2023년6월,편성보급,육군훈련소,32,71,39,60
2023년6월,지원보급,육군훈련소,71,90,19,52
2023년6월,물자근무지원,육군훈련소,15,49,34,62
2023년6월,조리,육군훈련소,278,332,54,46
2023년6월,수송운용(차량운전),육군훈련소,906,1698,792,99
2023년6월,수송운용(차량운전),1사단,61,173,112,102
2023년6월,수송운용(차량운전),25사단,30,100,70,102
2023년6월,수송운용(차량운전),9사단,61,218,157,104
2023년6월,수송운용(차량운전),3사단,53,135,82,99
2023년6월,수송운용(차량운전),6사단,64,131,67,98
2023년6월,수송운용(차량운전),5사단,60,145,85,102
2023년6월,수송운용(차량운전),28사단,60,145,85,100
2023년6월,수송운용(차량운전),51사단,39,190,151,106
2023년6월,수송운용(차량운전),55사단,51,272,221,105
2023년6월,견인차량운전,육군훈련소,30,41,11,95
2023년6월,차륜형장갑차운전,육군훈련소,34,36,2,93
2023년6월,차량부대정비,육군훈련소,58,49,-9,55
2023년6월,구난차량운전,육군훈련소,35,47,12,93
2023년6월,군사경찰,육군훈련소,83,157,74,48
2023년6월,일반의무,육군훈련소,170,883,713,74
2023년6월,배관/기계설비(중졸),육군훈련소,1,0,-1,0
2023년6월,전기설비(중졸),육군훈련소,1,0,-1,0
2023년6월,용접/기계공작(중졸),육군훈련소,1,0,-1,0
2023년6월,조리(중졸),육군훈련소,8,0,-8,0
2023년6월,수송운용(중졸),육군훈련소,44,1,-43,50
2023년6월,견인차량운전(중졸),육군훈련소,2,0,-2,0
2023년6월,지게차운전(중졸),육군훈련소,1,0,-1,0
2023년6월,차량부대정비(중졸),육군훈련소,10,0,-10,0
2023년6월,구난차량운전(중졸),육군훈련소,5,0,-5,0
2023년6월,전문치과,육군훈련소,2,9,7,71
2023년6월,전문임상병리,육군훈련소,2,4,2,78
2023년6월,전문방사선촬영,육군훈련소,5,5,0,75
2023년6월,전문약제,육군훈련소,15,53,38,80
2023년6월,전문물리치료,육군훈련소,3,21,18,79
2023년6월,천호운용/정비,육군훈련소,12,38,26,51
2023년6월,신호정보/전자전운용,육군훈련소,27,56,29,63
2023년7월,K계열전차승무,육군훈련소,63,64,1,46
2023년7월,전차통신정비,육군훈련소,3,6,3,58
2023년7월,장갑차조종,육군훈련소,77,61,-16,46
2023년7월,장갑차부대정비,육군훈련소,11,26,15,60
2023년7월,K-21보병전투차량승무,육군훈련소,23,21,-2,46
2023년7월,K-55자주포조종,육군훈련소,62,6,-56,46
2023년7월,K-9자주포조종,육군훈련소,67,16,-51,48
2023년7월,K239포병,육군훈련소,15,21,6,48
2023년7월,M/A포병,육군훈련소,4,5,1,62
2023년7월,사격지휘,육군훈련소,124,11,-113,53
2023년7월,포병레이더,육군훈련소,2,4,2,57
2023년7월,포병측지,육군훈련소,16,18,2,54
2023년7월,현무포병,육군훈련소,6,9,3,56
2023년7월,발칸운용/정비,육군훈련소,62,139,77,50
2023년7월,오리콘운용/정비,육군훈련소,20,60,40,53
2023년7월,비호운용/정비,육군훈련소,28,64,36,50
2023년7월,방공작전통제,육군훈련소,30,122,92,54
2023년7월,휴대용유도무기운용/정비,육군훈련소,16,167,151,59
2023년7월,군사정보,육군훈련소,26,50,24,62
2023년7월,땅굴탐지,육군훈련소,18,2,-16,64
2023년7월,감시장비운용,육군훈련소,172,108,-64,54
2023년7월,소방장비,육군훈련소,15,35,20,62
2023년7월,배관/기계설비,육군훈련소,3,11,8,82
2023년7월,전기설비,육군훈련소,1,39,38,90
2023년7월,장갑전투도저운전,육군훈련소,5,6,1,60
2023년7월,공기압축기운용,육군훈련소,2,2,0,62
2023년7월,크레인운용,육군훈련소,5,14,9,68
2023년7월,발전기운용/정비,육군훈련소,10,18,8,70
2023년7월,전술통신장비운용/정비,육군훈련소,187,21,-166,52
2023년7월,무선전송장비운용/정비,육군훈련소,97,43,-54,54
2023년7월,이동통신장비운용/정비,육군훈련소,118,5,-113,59
2023년7월,정보통신망관리장비운용/정비,육군훈련소,15,23,8,56
2023년7월,교환시설운용/정비,육군훈련소,13,6,-7,58
2023년7월,MW운용/정비,육군훈련소,14,55,41,86
2023년7월,위성운용/정비,육군훈련소,22,36,14,61
2023년7월,레이다운용/정비,육군훈련소,40,13,-27,57
2023년7월,네트워크운용/정비,육군훈련소,90,37,-53,54
2023년7월,전술C4I운용/정비,육군훈련소,69,34,-35,55
2023년7월,정보체계운용/정비,육군훈련소,55,42,-13,54
2023년7월,항공운항/관제,육군훈련소,12,33,21,64
2023년7월,기동헬기운용,육군훈련소,58,24,-34,55
2023년7월,화생방제독,육군훈련소,61,44,-17,46
2023년7월,화생방정찰,육군훈련소,18,47,29,64
2023년7월,총기정비,육군훈련소,8,13,5,59
2023년7월,화포정비,육군훈련소,1,1,0,67
2023년7월,광학기재정비,육군훈련소,7,22,15,89
2023년7월,감시장비정비,육군훈련소,2,9,7,68
2023년7월,자주포야전정비,육군훈련소,4,3,-1,62
2023년7월,장갑차야전정비,육군훈련소,3,3,0,62
2023년7월,유선장비정비,육군훈련소,7,10,3,58
2023년7월,무선장비정비,육군훈련소,8,12,4,62
2023년7월,특수통신장비정비,육군훈련소,4,6,2,60
2023년7월,차량정비,육군훈련소,7,54,47,87
2023년7월,발전기정비,육군훈련소,8,14,6,84
2023년7월,용접/기계공작,육군훈련소,1,27,26,96
2023년7월,화생방장비정비,육군훈련소,4,7,3,56
2023년7월,탄약관리,육군훈련소,167,61,-106,52
2023년7월,장비수리부속공구보급,육군훈련소,18,34,16,56
2023년7월,편성보급,육군훈련소,33,37,4,54
2023년7월,영현등록,육군훈련소,4,7,3,64
2023년7월,지원보급,육군훈련소,69,51,-18,52
2023년7월,연료관리,육군훈련소,25,5,-20,51
2023년7월,물자근무지원,육군훈련소,15,38,23,61
2023년7월,조리,육군훈련소,339,178,-161,45
2023년7월,수송운용(차량운전),육군훈련소,1357,1470,113,93
2023년7월,수송운용(차량운전),1사단,61,193,132,104
2023년7월,수송운용(차량운전),25사단,61,123,62,97
2023년7월,수송운용(차량운전),9사단,60,221,161,105
2023년7월,수송운용(차량운전),3사단,53,67,14,93
2023년7월,수송운용(차량운전),6사단,64,79,15,93
2023년7월,수송운용(차량운전),5사단,60,90,30,96
2023년7월,수송운용(차량운전),28사단,30,86,56,100
2023년7월,수송운용(차량운전),55사단,24,349,325,111
2023년7월,견인차량운전,육군훈련소,30,17,-13,93
2023년7월,지게차운전,육군훈련소,29,58,29,68
2023년7월,차륜형장갑차운전,육군훈련소,34,10,-24,93
2023년7월,차량부대정비,육군훈련소,14,22,8,58
2023년7월,K-53계열차량운전,육군훈련소,4,2,-2,97
2023년7월,구난차량운전,육군훈련소,35,26,-9,93
2023년7월,크레인차량운전,육군훈련소,16,5,-11,97
2023년7월,전장이동통제,육군훈련소,16,86,70,77
2023년7월,항만운용,육군훈련소,11,30,19,66
2023년7월,선박운용,육군훈련소,3,5,2,52
2023년7월,군사경찰,육군훈련소,166,150,-16,46
2023년7월,재정회계,육군훈련소,9,47,38,81
2023년7월,일반의무,육군훈련소,280,785,505,72
2023년7월,수의,육군훈련소,29,44,15,61
2023년7월,배관/기계설비(중졸),육군훈련소,1,0,-1,0
2023년7월,전기설비(중졸),육군훈련소,1,1,0,46
2023년7월,용접/기계공작(중졸),육군훈련소,1,0,-1,0
2023년7월,조리(중졸),육군훈련소,10,0,-10,0
2023년7월,수송운용(중졸),육군훈련소,68,0,-68,0
2023년7월,견인차량운전(중졸),육군훈련소,2,0,-2,0
2023년7월,지게차운전(중졸),육군훈련소,2,0,-2,0
2023년7월,차량부대정비(중졸),육군훈련소,10,0,-10,0
2023년7월,구난차량운전(중졸),육군훈련소,5,0,-5,0
2023년7월,선박운용(중졸),육군훈련소,1,0,-1,0
2023년7월,전문간호,육군훈련소,6,27,21,87
2023년7월,신호정보/전자전운용,육군훈련소,14,36,22,70
2023년8월,K계열전차승무,육군훈련소,32,43,11,46
2023년8월,M계열전차승무,육군훈련소,35,10,-25,46
2023년8월,장갑차조종,육군훈련소,43,24,-19,46
2023년8월,장갑차부대정비,육군훈련소,12,14,2,56
2023년8월,K-21보병전투차량승무,육군훈련소,23,8,-15,46
2023년8월,K-21보병전투차량부대정비,육군훈련소,7,6,-1,52
2023년8월,K239포병,육군훈련소,15,14,-1,56
2023년8월,M/A포병,육군훈련소,4,3,-1,58
2023년8월,사격지휘,육군훈련소,56,8,-48,54
2023년8월,포병레이더,육군훈련소,2,4,2,56
2023년8월,포병측지,육군훈련소,18,10,-8,57
2023년8월,현무포병,육군훈련소,5,10,5,58
2023년8월,발칸운용/정비,육군훈련소,70,96,26,46
2023년8월,비호운용/정비,육군훈련소,28,48,20,49
2023년8월,방공작전통제,육군훈련소,30,161,131,54
2023년8월,천마운용/정비,육군훈련소,19,81,62,60
2023년8월,군사정보,육군훈련소,13,32,19,62
2023년8월,감시장비운용,육군훈련소,85,52,-33,56
2023년8월,배관/기계설비,육군훈련소,8,8,0,70
2023년8월,전기설비,육군훈련소,1,32,31,91
2023년8월,다목적굴착기운전,육군훈련소,1,34,33,77
2023년8월,도하장비조종,육군훈련소,6,5,-1,56
2023년8월,공기압축기운용,육군훈련소,2,1,-1,84
2023년8월,크레인운용,육군훈련소,4,10,6,67
2023년8월,전술통신장비운용/정비,육군훈련소,139,158,19,46
2023년8월,무선전송장비운용/정비,육군훈련소,50,40,-10,54
2023년8월,이동통신장비운용/정비,육군훈련소,70,104,34,46
2023년8월,정보통신망관리장비운용/정비,육군훈련소,14,9,-5,60
2023년8월,교환시설운용/정비,육군훈련소,7,7,0,58
2023년8월,MW운용/정비,육군훈련소,28,70,42,70
2023년8월,위성운용/정비,육군훈련소,47,19,-28,57
2023년8월,레이다운용/정비,육군훈련소,39,11,-28,56
2023년8월,네트워크운용/정비,육군훈련소,67,22,-45,56
2023년8월,전술C4I운용/정비,육군훈련소,46,28,-18,53
2023년8월,정보체계운용/정비,육군훈련소,34,23,-11,56
2023년8월,항공운항/관제,육군훈련소,14,40,26,66
2023년8월,화생방제독,육군훈련소,31,60,29,52
2023년8월,전차정비,육군훈련소,5,6,1,60
2023년8월,무선장비정비,육군훈련소,9,18,9,61
2023년8월,차량정비,육군훈련소,1,44,43,89
2023년8월,공병장비정비,육군훈련소,4,6,2,62
2023년8월,발전기정비,육군훈련소,6,30,24,87
2023년8월,용접/기계공작,육군훈련소,1,12,11,92
2023년8월,의무장비정비,육군훈련소,7,29,22,83
2023년8월,탄약관리,육군훈련소,65,45,-20,56
2023년8월,장비수리부속공구보급,육군훈련소,18,14,-4,55
2023년8월,편성보급,육군훈련소,32,22,-10,56
2023년8월,지원보급,육군훈련소,23,36,13,49
2023년8월,연료관리,육군훈련소,25,5,-20,58
2023년8월,물자근무지원,육군훈련소,15,30,15,61
2023년8월,조리,육군훈련소,128,149,21,46
2023년8월,수송운용(차량운전),육군훈련소,732,887,155,95
2023년8월,수송운용(차량운전),1사단,61,174,113,103
2023년8월,수송운용(차량운전),25사단,60,126,66,98
2023년8월,수송운용(차량운전),9사단,31,127,96,104
2023년8월,수송운용(차량운전),3사단,26,32,6,93
2023년8월,수송운용(차량운전),6사단,64,76,12,93
2023년8월,수송운용(차량운전),5사단,60,88,28,96
2023년8월,수송운용(차량운전),28사단,90,122,32,95
2023년8월,수송운용(차량운전),51사단,62,206,144,101
2023년8월,수송운용(차량운전),55사단,53,211,158,102
2023년8월,견인차량운전,육군훈련소,30,5,-25,93
2023년8월,지게차운전,육군훈련소,25,32,7,62
2023년8월,K-53계열차량운전,육군훈련소,4,1,-3,103
2023년8월,전장이동통제,육군훈련소,16,58,42,73
2023년8월,항만운용,육군훈련소,11,25,14,65
2023년8월,재정회계,육군훈련소,9,38,29,75
2023년8월,의무보급,육군훈련소,15,84,69,69
2023년8월,배관/기계설비(중졸),육군훈련소,1,0,-1,0
2023년8월,전기설비(중졸),육군훈련소,1,0,-1,0
2023년8월,용접/기계공작(중졸),육군훈련소,1,0,-1,0
2023년8월,조리(중졸),육군훈련소,4,1,-3,51
2023년8월,수송운용(중졸),육군훈련소,37,0,-37,0
2023년8월,견인차량운전(중졸),육군훈련소,2,0,-2,0
2023년8월,지게차운전(중졸),육군훈련소,2,0,-2,0
2023년8월,전문치과,육군훈련소,1,3,2,77
2023년8월,전문임상병리,육군훈련소,2,2,0,79
2023년8월,전문방사선촬영,육군훈련소,5,4,-1,74
2023년8월,전문약제,육군훈련소,3,4,1,80
2023년8월,전문물리치료,육군훈련소,1,4,3,83
2023년8월,신호정보/전자전운용,육군훈련소,15,30,15,60
2023년9월,K계열전차승무,육군훈련소,31,0,-31,0
2023년9월,장갑차조종,육군훈련소,40,0,-40,0
2023년9월,K-55자주포조종,육군훈련소,31,0,-31,0
2023년9월,K-9자주포조종,육군훈련소,34,0,-34,0
2023년9월,K239포병,육군훈련소,30,0,-30,0
2023년9월,M/A포병,육군훈련소,4,0,-4,0
2023년9월,사격지휘,육군훈련소,84,0,-84,0
2023년9월,포병레이더,육군훈련소,1,0,-1,0
2023년9월,포병측지,육군훈련소,18,0,-18,0
2023년9월,현무포병,육군훈련소,5,0,-5,0
2023년9월,군사정보,육군훈련소,26,0,-26,0
2023년9월,감시장비운용,육군훈련소,83,0,-83,0
2023년9월,소방장비,육군훈련소,14,0,-14,0
2023년9월,장갑전투도저운전,육군훈련소,5,0,-5,0
2023년9월,정수장비운용,육군훈련소,10,0,-10,0
2023년9월,공기압축기운용,육군훈련소,1,0,-1,0
2023년9월,크레인운용,육군훈련소,4,0,-4,0
2023년9월,로더운전,육군훈련소,9,0,-9,0
2023년9월,발전기운용/정비,육군훈련소,3,0,-3,0
2023년9월,전술통신장비운용/정비,육군훈련소,198,0,-198,0
2023년9월,무선전송장비운용/정비,육군훈련소,76,0,-76,0
2023년9월,이동통신장비운용/정비,육군훈련소,68,0,-68,0
2023년9월,정보통신망관리장비운용/정비,육군훈련소,15,0,-15,0
2023년9월,교환시설운용/정비,육군훈련소,8,0,-8,0
2023년9월,위성운용/정비,육군훈련소,23,0,-23,0
2023년9월,레이다운용/정비,육군훈련소,18,0,-18,0
2023년9월,네트워크운용/정비,육군훈련소,41,0,-41,0
2023년9월,전술C4I운용/정비,육군훈련소,20,0,-20,0
2023년9월,정보체계운용/정비,육군훈련소,57,0,-57,0
2023년9월,기동헬기운용,육군훈련소,27,0,-27,0
2023년9월,화생방제독,육군훈련소,54,0,-54,0
2023년9월,유선장비정비,육군훈련소,7,0,-7,0
2023년9월,용접/기계공작,육군훈련소,1,0,-1,0
2023년9월,화생방장비정비,육군훈련소,5,0,-5,0
2023년9월,탄약관리,육군훈련소,60,0,-60,0
2023년9월,편성보급,육군훈련소,16,0,-16,0
2023년9월,지원보급,육군훈련소,47,0,-47,0
2023년9월,연료관리,육군훈련소,23,0,-23,0
2023년9월,물자근무지원,육군훈련소,15,0,-15,0
2023년9월,조리,육군훈련소,193,0,-193,0
2023년9월,수송운용(차량운전),육군훈련소,871,0,-871,0
2023년9월,수송운용(차량운전),1사단,30,0,-30,0
2023년9월,수송운용(차량운전),25사단,31,0,-31,0
2023년9월,수송운용(차량운전),9사단,60,0,-60,0
2023년9월,수송운용(차량운전),3사단,53,0,-53,0
2023년9월,수송운용(차량운전),6사단,64,0,-64,0
2023년9월,수송운용(차량운전),5사단,60,0,-60,0
2023년9월,수송운용(차량운전),51사단,33,0,-33,0
2023년9월,수송운용(차량운전),55사단,33,0,-33,0
2023년9월,견인차량운전,육군훈련소,30,0,-30,0
2023년9월,차륜형장갑차운전,육군훈련소,34,0,-34,0
2023년9월,크레인차량운전,육군훈련소,12,0,-12,0
2023년9월,전장이동통제,육군훈련소,16,0,-16,0
2023년9월,군사경찰,육군훈련소,166,0,-166,0
2023년9월,일반의무,육군훈련소,160,0,-160,0
2023년9월,용접/기계공작(중졸),육군훈련소,1,0,-1,0
2023년9월,조리(중졸),육군훈련소,6,0,-6,0
2023년9월,수송운용(중졸),육군훈련소,41,0,-41,0
2023년9월,견인차량운전(중졸),육군훈련소,2,0,-2,0
2023년9월,지게차운전(중졸),육군훈련소,1,0,-1,0
2023년9월,전문간호,육군훈련소,6,0,-6,0
2023년9월,신호정보/전자전운용,육군훈련소,28,0,-28,0
